###############################
###############################
###############################
###############-###############
##############---########v#####
##############---###----------#
##############---###----------#
###############-####----------#
###############-####----------#
###############-####----------#
#############-----##----------#
#####-######-------#----------#
###+++++####-------#----------#
###+++++####-------######-#####
###+++++######---########-#####
#--+++++--#####-#########-#####
#-#+++++--#####-#########-#####
#-#+++++#-#####-#########-#####
#-#+++++#-----------------#####
#-###-#########################
#-#############################
#-#############################
#-#############################
#-######------+++------########
#-##-#-#------+#+------#-#-####
#-------------+++----------####
########------+++------########
########------+++------########
###############-###############
###############-###############
###############################
###############################