###############################
###############################
###############################
###############-###############
##############---########v#####
##############---###----------#
##############---###--------#-#
###############-####--------#-#
###############-####----#-----#
###############-####-#------#-#
#############-----##-----#---##
#####-######-------#---#------#
###-----####-------#----------#
###-----####-------######-#####
###-----######---########-#####
#---------#####-#########-#####
#-#-----#-#####-#########-#####
#-#-----#-#####-#########-#####
#-#-----#-----------------#####
#-###-#########################
#-#############################
#-#############################
#-#############################
#-######---------------########
#-##-#-#---------------#-#-####
#--------------------------####
########---------------########
########---------------########
###############-###############
###############-###############
###############################
###############################