####################################
####################################
####################################
########...~~###############..~~~###
#######..~~~~~~#############~#~#~###
######..~~~~~~~~##############~#####
######~~~~~~~~~~##############~#####
######~~~~~~~~~~####~~~#######~#####
######~~~~~~~~~####~~~...####~~##~##
######~~~~~~~~~###~~~~~...##~~~#~~~#
######~~~~~~~#######~~##~..#~~##~~~#
#######~~~~~############~~~~~#####~#
#########~~~############~~~#######~#
#########~~~###~~~~###~~~~~#######~#
#########~~~#~~~~~~~#~~~~~~####~##~#
#########~~~~~~~~~~~~~~~~~~~~~~~##~#
#########~~~#~~~~~~~~~~###~~~##~#~~#
#########..~###~~~~~###########~~~~#
#########...########################
#########...####################~~~#
########....#########~###########~##
#######~~~....#####~~~~~...~.####~##
#######~~#~~.....#~~~~~~~....####~##
#######~###~~~..~~~~~~~~~###.#.~#~##
######~~####~~~~~~~.########....~~~#
######~~####~##############~~.~~~~~#
######~~~#######~~~####~~~~~~~~~~~##
#######~~#####~~~~~~~~~~~~~~~~~#####
#######~~~####~~~~~~~~~~~~~~########
########~~##########################
########~###########################
####################################
####################################