####################################
####################################
####################################
########+++++###############-----###
#######++++++++#############-#-#-###
######++++++++++##############-#####
######+++---++++##############-#####
######+++---++++####---#######-#####
######+++---+++####------####--##-##
######+++++++++###--------##---#---#
######+++++++#######--##---#--##---#
#######+++++############-----#####-#
#########+--############---#######-#
#########---###++++###-----#######-#
#########---#-++++++#------####-##-#
#########-----++++++------------##-#
#########---#-++++++---###---##-#--#
#########---###+--+-###########----#
#########---###################vvvv#
#########---##################vv---#
########----#########-########vvv-##
#######-------#####----------#vv#-##
#######--#-------#-----------vvv#-##
#######-###--------------vvv-v--#-##
######--####--------vvvvvvvv-------#
######--####-vvvvvvvvvvvvvv--------#
######---###vvvv---vvvv-----------##
#######--##vvv-----------------#####
#######---#vv#--------------########
########--vv########################
########-vv#########################
########vvv#########################
#######vvv##########################