##############################
##############################
##############################
#######~~~~~~~~~~~~~..####~~.#
####~~~~~~~~~~~~~~~~....###~~#
##~~~~~~#~########~~~~...###~#
#~~~~~~~#############~#.~###~#
###~~~~~###############~~###~#
###~~~~~###~~~~~#######~~~##~#
####~~~~~~~~~~~~~~~~~##~~~##~#
######~~~~######~~~~~~~~~~~#~#
#######~##########~~~~~~~~~#~#
####################~~~~~~~~~#
###########~~~~#####~#~~~~~~~#
#########~~~~~~~.###~##~~~~~.#
######~~~~~~~~~~~~##~##~~~~..#
######~~~~~~~~~~~#~#~##.....##
##~..#~~~~~~~~~~~###~#......##
##~.....~~~~~~~~####........##
##~~.#...~~~##~######~~~...###
##~~~#....~###~########~~~####
##~~~####~####~########..#####
###~#####~####~########~.#####
###~#####~##~-~~######~~~#####
###~#####~~~~~~~~~~~~~~~~#####
##~~#####~~~~~~~~~~~~~~#######
##########~~~~~~~~~~##########
###########~~~~~##############
############~~~###############
##############################
##############################