##############################
##############################
##############################
#######---------------####---#
####--------------------###--#
##------#-########-------###-#
#-------#############-#--###-#
###-----###############--###-#
###-----###-----#######---##-#
####-----------------##---##-#
######----######-----------#-#
#######-##########---------#-#
####################---------#
###########----#####-#-------#
#########--------###-##------#
######------------vv-##------#
######-----------v-v-##-----##
##---#-----------vvv-#------##
##--------------vvvv--------##
##---#------##-vvvvvv------###
##---#-----###-vvvvvvvv---####
##---####-####-vvvvvvvv--#####
###-#####-####-vvvvvvvv--#####
###-#####-##----vvvvvv---#####
###-#####----------------#####
##--#####--------------#######
##########----------##########
###########-----##############
############---###############
##############################
##############################