###############################
###############################
###############################
###############.###############
##############...##############
##############~~~###~~........#
##############~~~###~~~.....#~#
###############~####~~~..~~~#~#
###############~####~~~~#~~~~~#
###############~####~#~~~~~~#~#
#############..~~~##~~~~~#~~~##
#####~######~~~~~~~#~~~#~~~~~.#
###~~~~~####~~~~~~~#~~~~~~~...#
###~~~~~####~~~~~~~######~#####
###~~~~~######~~~########~#####
#..~~~~...#####~#########~#####
#~#~~....~#####~#########~#####
#.#.....#.#####~#########~#####
#.#.....#.~~~~~~~~~~~~~~~~#####
#.###.#########################
#~#############################
#~#############################
#~#############################
#~######.......~~~~....########
#~##~#~#~~~~~~~#~~~....#~#~####
#~~...~~~~~~~~~~~~~~~~..~~~####
########~~~~~~~~~~~~~~~########
########...~~~~~~~~~~~.########
###############~###############
###############.###############
###############################
###############################