00000000000000000000000000000000000
00000000000000000000000000000000000
00000000000000000000000000000000000
00000000000000000000000000000000000
00000000000000000000000000000000000
00000000000000000000000000000000000
00000000000000000000000000000000000
00000000000000000000000000000000000
00000000000000000000000010010000000
00000000000000000000000021120000000
00000000000000000000000032230000000
00000000000000000000000040340034000
00000000000000000000005050050045400
00000000000000000100456660066006500
00000000000011000204567770077007600
00000000000122222345678888888008080
01000000000233330056789999999999990
02001000300344440007889888888008880
03032123444455550008999877777007700
04040004555066660008988000666006600
05050005666077770099900000555055000
06060006777088889998000000044344000
07077007888099999007000000030030000
08088888999998888006001000020000000
99999999988087777005432100010000000
08888800070076666034321000000000000
07777700060065555023210000000000000
06666600050054444322100000000000000
05555543340043330001000000000000000
00444432232232220000000000000000000
00000321120001000000000000000000000
00000000000000000000000000000000000
00000000000000000000000000000000000
00000000000000000000000000000000000
00000000000000000000000000000000000