000000000000000000000000000000
000000000000000000000000000000
000000000000000000000000000000
000000000000000000000000000000
000000000000000000000000000000
000000000000000121000000000000
000000000000000030000000000000
000000000000000040000000000000
000000000000000050000000000000
000000000000000060000000000000
000000000000000070000000000000
000000000000000080000000000000
000000000012345090000000000000
000000000123456780000000000000
000000000012345070000000000000
000000000001234060010000000000
000000000000123050121000000000
000000000000000040232100000000
000000000000000040040000000000
000000000000000050050000000000
000000000000000060060000000000
000000000043000077770100000000
000000000054322088880200000000
000000000060223099990300000000
000000000070234088880400000000
000000000000345677776500000000
000000000000000000000000000000
000000000000000000000000000000
000000000000000000000000000000
000000000000000000000000000000
000000000000000000000000000000
000000000000000000000000000000
000000000000000000000000000000
000000000000000000000000000000
000000000000000000000000000000
000000000000000000000000000000