###################################
###################################
###################################
###########-----###############...#
###...####.------######,,.#.##....#
###....##..-------####,,,.,.##....#
##.,...##..-------###.....,,,#,..##
##..,,,,...------..##.......,######
#....#######-----...........,######
#...########-----..##.##....#######
#.#.########.#--...#####....#######
#.#.##...##..###..######.#..#######
#.#,#,,,,,,,.####.####.#,##,#######
#.#....,,##,,####.##,...,##..######
#.#....####..,###.#,....,##.,##..##
#.##..#####..........,,,,,.,,##.#.#
#.##..#####.....##..,,#############
#.##..##.##,....###,,........##...#
#.#........,,,,,###,###......##..##
#.#.###....#..,,###.#..###...##,,##
#.#.###....#...,###.######..,##,###
#.#.###....#...,###.#######,,.#.###
#.#,,##,...########.#######.#######
#.#,,..,#####....##.##..###.#######
#.##.####..#.....##..----.#.#######
#.....######-----#,,,----...#######
#.....###.##-----#...----..,#######
#,....######-----....----.,,#######
#,........##,...###...---##########
##,,......,,,,,,###....############
#####,....###.#######.#############
###################################
###################################
###################################
###################################