###################################
###################################
###################################
###########+++++###############---#
###---####-++++++######---#-##----#
###----##--+++++++####------##----#
##----###--+++++++###-------+v---##
##---------++++++--##--------######
#----#######+++++------------######
#---########+++++--##-##----#######
#-#-########-#++---#####----#######
#-#-##---##--###--######-#--##vv###
#-#-#--------####-####-#-##-##vvv##
#-#------##--####-##-----##--##vv##
#-#----####---###-#------##--##--##
#-##--#####------------------##-#-#
#-##--#####-----##----vvvvvvvvvvvv#
#-##--##-##-----###---v------##---#
#-#-------------###-vvv------##--##
#-#-###----#----###-v--###---##--##
#-#-###----#----##vvv#####---#v-###
#-#-###----#----vvv-#######---v-###
#-#--##----#vvvvv##-#######-##v####
#-#-----vvvvv----##-##--###-#######
vvvvvvvvv--#-----##--++++-#-#######
#-----######+++++#---++++---#######
#-----######+++++#---++++---#######
#-----######+++++----++++---#######
#--------###----###---+++##########
##--------------###----############
#####-----###-#######-#############
###################################
###################################
###################################
###################################