##############################
##############################
##############################
##########....##..############
##########.....#...###########
#########..........###########
#########.......#.############
###########..####.############
#################.############
#################.############
##############.......#########
##--#####.##....###...########
#---#.....##....####---#######
#----.###.......####----######
#----.###.........##----######
#----.###.##......#.----.#####
#--.#.....##.........-########
#--###.#..##.......#.#########
######.##..........#.#########
######.###.........#.##...####
####--..##.....#...#......####
##.---#.##.....#####.----#####
###---#........#####.----#####
###---###.....######-----#####
####--###.....##....----######
####..###..##.##..###---######
#####.....###.....###..#######
#####.....###.##..###..#######
############..##......########
##############################
##############################