##############################
##############################
##############################
##########----##--############
##########-----#---###########
#########----------###########
#########-------#-############
###########--####-############
#################-############
#################-############
##############-------#########
##++#####-##----###---########
#+++#-----##----####+++#######
#++++-###-------####++++######
#++++-###---------##++++######
#++++-###-##------#-++++-#####
#++-#-----##---------+########
#++###-#--##-###---#-#########
######-##-----#-#--#-#########
######-###---------#-##---####
####++--##-----#---#------####
##-+++#-##--##-#####-++++#####
###+++#----#---#####-++++#####
###+++###-----######+++++#####
####++###-----##----++++######
####--###--##-##--###+++######
#####-----###-----###--#######
#####-----###-##--###--#######
############--##------########
##############################
##############################