##############################
##############################
##############################
##########----##--############
##########-----#---###########
#########----------###########
#########-------#-############
###########--####-############
#################-############
#################-############
##############-------#########
##++#####-##----###---########
#+++#-----##----####+++#######
#++++-###-------####++++######
#++++-###---------##++++######
#++++-###-##------#-++++-#####
#++-#-----##---------+########
#++###-#--##-------#-#########
######-##----------#-#########
######-###---------#-##---####
####++--##-----#---#------####
##-+++#-##-----#####-++++#####
###+++#--------#####-++++#####
###+++###-----######+++++#####
####++###-----##----++++######
####--###--##-##--###+++######
#####-----###-----###--#######
#####-----###-##--###--#######
############--##------########
##############################
##############################