##############################
##############################
##############.###############
####.......##..###############
####.......##..###############
##,,.......#........,,,#######
####.......#####.#####,#######
####.......#####,#####...#####
########...#####,#######.#####
########.#######,#######...###
########,#######.###.#####.###
##..#..,,#######,##..,####.###
##..#,,,,#,,,,,###.,,,,###,###
##.###,#,,....,,,#...,,#..,,,#
##.###,###....,#.#.....#.,,,,#
##.###,###....,#.#,....#,,,,,#
##.###.###..,,,#.#,....#..,,,#
#...#.,,####.###.#,,...###.###
##.###.#########.##,#.##...,,#
##.###.#########.##,#.##..####
##.###,#########.##,#.##.#####
#...#,,.##..####....#.##.#####
##.###,###.....#....#.##.#####
##.###.###,#...######.##.,####
##,###.###,#...#....#.###.,,.#
#,,,#.,.,#,#..........####,,,#
##,###,###,###############.,,#
##,###.###.###############..,#
##.###.###.###############,..#
##.#.#,#,,,......,,,,,,,,,...#
##..,,,#.#####################
##############################
##############################
##############################
##############################
##############################