################################
################################
################################
#,,,,.##..................######
#,,,,.....#####-----##...#######
#,,,,,##..#####-----##...#######
###,####..#####-----##...#######
###.#####.############...#######
###.#####.######################
###.#####.######################
##,,.#,##.##..,,##.,,###########
###,##,##.##.##.##.#..,,########
###,##,,...............,########
###,##.,#.##.##.##.#....########
##.,,#..#,,...#....#....########
###.##..#..,..##################
###.##.##,##,,###...############
###.##.#...#.,#.....############
##...#.#.#.#..#.#...############
###.##.#....,......,############
###.##.#.#.####.##.#####..######
###.##.##...###.......#..#######
##...#.###,,###..#.####.,#######
###.##.###########.#.##.########
###.##....................###.##
###.###....###...###.##.#.##.,##
###..##....###..,######......,,#
##########.###.,,#########..,..#
###############,##########.....#
###############.##########.....#
#########################......#
################################