###################################
###################################
###################################
###########+++++###############---#
###---####-++++++######---#-##----#
###----##--+++++++####------##----#
##-----##--+++++++###-------+v---##
##---------++++++--##--------######
#----#######+++++------------######
#---########+++++--##-##----#######
#-#-########-#++---#####----#######
#-#-##---##--###--######-#--##vv###
#-#-#--------####-####-#-##-##vvv##
#-#------##--####-##-----##--##vv##
#-#----####---###-#------##--##--##
#-##--#####------------------##-#-#
#-##--#####-----##--------------vv#
#-##--##-##-----###----------##---#
#-#-------------###----------##--##
#-#-###----#----###----###---##--##
#-#-###----#----##---#####---#v-###
#-#-###----#--------#######---v-###
#-#--##----#-----##-#######-##v####
#-#--------------##-##--###-#######
#----------#-----##--++++-#-#######
#-----###v##+++++#---++++---#######
#-----###-##+++++#---++++---#######
#-----###v##+++++----++++---#######
#---------##----###---+++##########
##--------------###----############
#####-----###-#######-#############
###################################
###################################
###################################
###################################