##############################
##############################
##############-###############
####+++++++##--###############
####+++++++##--###############
##--+++++++#-----------#######
####+++++++#####-#####-#######
####+++++++#####-#####---#####
########+++#####-#######-#####
################-#######---###
########-#######-###-#####-###
##--#----#######-##---####-###
##--#----#-----#v#-----###-###
##-###-#---------#-----#-----#
##-###-###-----#-#-----#-----#
##-###-###-----#-#-----#-----#
##-###-###-----#-#-----#-----#
#---#---####-###-#-----###-###
##-###-#########-##-#-##-----#
##-###-#########-##-#-##--####
##-###-#########-##-#-##-#####
#---#---##--####----#-##-#####
##-###-###-----#----#-##-#####
##-###-###-#---#vvvv#-##--####
##-###-###-#---#----#-###----#
#---#----v-#----------####---#
##-###-###-###############---#
##-###-###-###############---#
##-###-###-###############---#
##-#-#-#---------------------#
##-----#-#####################
##############################
##############################
###############################
##############################
##############################