###################################
###############.....###############
###############.....###############
###############.....###############
###############.....#######..######
########.#########=####.##...######
#######..#####..##..###....#.######
#######..#..#..##....##....########
#############..###...=........#####
#############..##.#.####..#....####
##############.########..####=#####
#################.#########...#####
##########.###=###.#######......###
##########..##############.##..####
###########....##########..##..####
#####.######....#########..##...###
####...##.####..########...##....##
#####...#.#####=#############.....#
#####.......##.....###.######.....#
####..#.....=.......##..##..#.....#
#####.##.####.##........##..#....##
#####=####..###....####=###.....###
#####..##..#####..#####.#.#....####
####...###..###########.####=######
####....###..##########.####.######
#####....##############.####..#####
#####.....=...#######.#.##.#...####
######....#...#######......##...###
######...###.....###........=...#.#
######.####......##.....#...#.....#
##########.......==...####.###....#
##########....#####################
###################################
###################################
###################################
