##############################
##############################
##############################
#..######.###................#
#....##....#....####.###.#####
#..........#....####.###.#####
#..........#....####.###.#####
#.#####.####....#......#.....#
#.#####.####.................#
#.#####.####..###.....###....#
#...#.....##.####.....###....#
#...#......#.####.....###....#
#.........##.##..............#
##..#####.##..........####.###
##..#####.##..........####.###
##..#####.##..........####.###
##....#....#...##.#....#.....#
##....#....##.###.##.###.....#
#..........##.###.##.###....##
#.######...##.##..##.###....##
#.#######..#................##
#.#######.##...#.......#....##
#....####.##.###.......#....##
#.......#.##.###.###.###.....#
######..#..#.###.###.###.....#
######..#..#...#.###.#####.###
######.....#...#.#.....###.###
#########..#...........###.###
#########..#.....#...........#
##############################