##############################
##############################
##############################
#-##-##--##--#-#--##--##-##-##
#--#--##-------------##--#--##
#--##-####---------####-##--##
#--##-#####v##-##v#####-##--##
#--##--###---------###--##--##
##-#--####---------####--#-###
##-#-#######-----#######-#-###
##---#########-#########---###
###--#########-#########--####
###---#--#####-######--#--####
###------####---#####-----####
##-------####+++####-------###
#--------##---+---##--------##
#-------------+-------------##
#-------------+-------------##
#--#####-vv+vvvvv+vv-#####--##
########vvv--vvv--vvv#########
########vv---------vv#########
####vvvvv##-------##vvvvv#####
vvvvvvv####-------####vvvvvvvv
vvvvv######-------######vvvvvv
############-----#############
############-----#############
#############---##############
##############-###############
##############-###############
##############################
##############################
##############################