##############################
##############################
##############################
#.##.##..##..#.#..##..##.##.##
#..#..##.............##..#..##
#..##.####.........####.##..##
#..##.########.########.##..##
#..##..###.........###..##..##
##.#..####.........####..#.###
##.#.#######.....#######.#.###
##...#########.#########...###
###..#########.#########..####
###...#..#####.######..#..####
###......####...#####.....####
##.......####...####.......###
#........##.......##........##
#...........................##
#...........................##
#..#####.##=##=##=##.#####..##
###########..###..############
##########.........###########
###########.......############
###########.......############
###########.......############
############.....#############
############.....#############
#############...##############
##############.###############
##############.###############
##############################
##############################
##############################