###############################
###############################
###############################
######################+++++++-#
####-########---------+++++++-#
##-------------------#+++++++-#
###---##-----#########+++++++-#
###vvv#####################---#
###---#####################--##
##-----##########-#########--##
##-----#v----####------------##
##-----#---v-####-#############
###---####-######-#############
####--####-###-##-#############
####--####-###--------------###
####---------v-##-#########-###
#################-#########-###
#################-#########---#
#################-#########---#
#######-#########-#####-------#
##-------########-#####---#####
###--###-########-#####---#####
###--###-###--------#####-#####
###--###--##--------#####-#####
##----##--##--------#####-#####
##---------------------##----##
##----##------------##-#####--#
###--###--##--------##-#####-##
###--###-###--------##-#####-##
###--##vv############--------##
#--------######################
###############################
###############################
###############################
###############################
###############################