###############################
###############################
###############################
######################........#
####.########.................#
##...................#........#
###...##.....#########........#
###########################...#
###...#####################..##
##.....##########.#########..##
##.....##....####............##
##.....#...#.####.#############
###...####.######.#############
####..####.###.##.#############
####.#####.###..............###
####.........#.##.#########.###
#################.#########.###
#################.#########...#
#################.#########...#
#######.#########.#####.......#
##.......########.#####...#####
###..###.########.#####...#####
###..###.###........#####.#####
###..###..##........#####.#####
##....##..##........#####.#####
##.....................##....##
##....###...........##.#####..#
###..###..##........##.#####.##
###..###.###........##.#####.##
###..################........##
#........######################
###############################
###############################
###############################
###############################
###############################