##############################
##############################
##############################
######-----####.....##########
#####------.........###.######
##....-----......######.######
##....----..###...######...###
##....----..###.......###...##
##...##########.......###...##
##...#############....###...##
##...##############...#.#...##
##...###----#######...####..##
###..###----#...###.....##..##
##.....#----#...###.....##..##
##.....#----.#..###...####..##
##.....#######..###...####..##
##.....#######..###...####..##
##.....#######..###...###...##
##....#######.........###...##
##....#######.........###...##
##....#######.........####..##
##....####################..##
##....####################..##
##...-----##########........##
##..------##########........##
###-------##########....######
#####----...............######
#####---................######
###########....###.......#####
##############################
##############################