##################################
##################################
##################################
#...########################..####
##..#####...........#######...####
###.##..................###...####
###..........######......##...####
###....###############...###..####
###...######....#######...##..####
##...####.........#####...##.#####
#....###....####...#####..#..#####
#---###....######...####....######
#---###...########...###....######
#---##...####..####..####...######
#--###...###..#####..####---######
#..##....###.######---###---######
#..####..###.##.###---###----#####
#...###..#...##.###---###----#####
##..###..###....#..---###----#####
##..##...####........##..#---#####
##..##....#####....#######...#####
##...#.....###############...#####
###..###...###############..######
###...###.....###########..##.####
####...###.......#####....###.####
#####...######............########
######..#############..##.########
######..#############.############
######.####..########.#######.####
#####...####..........#####...####
############################.#####
##################################
##################################
##################################