####################################
####################################
####################################
####################################
######--------##---###------########
###-----------------#---###--#######
###vvvvvvv--------------###--#######
###-----vv-vv-----------###--#######
###+++++---vvv--vvvv----#-#-########
##-+++++--##vvvvvvvvv---#---########
##-++++#####-vv----vvv--#vvv########
##-++++#####--#-----vvvvvvvv########
##-++--####---##------#-----########
###v----------##------##----###----#
###vvvvv---------------#-##--v-----#
###---vvv----------------##-###----#
###----vvvvvv------------##v########
##--------#vvv---vv------#vv########
##--#-+++++-vvvvvvvv-----vvv########
##-##-+++++-------vvv---vvv#########
##----+++++---------vv-vvv-#########
###-#-++++++--#---#--------#########
###---++##++------#-------##########
###---######---------#----##########
####--######----#-------############
####--#######---#-------###-########
####--####-##---#----#--###-########
####---#-#--#-----####---#--########
######---v------####---------#######
########vv##########################
########vv##########################
#########v##########################