##################################
##################################
##################################
############....##......##......##
#######..###...###.....###.......#
######----.#...##....#####.......#
####------.#..###...########.....#
####------.#.##....##..#####..####
#####-----#####...##.....#########
######....######..##.....##.######
######...###..######.....##.###.##
######.####...########....####..##
############.###.--###....###...##
#########..####..--####.####....##
########...####.---##.######....##
########....###-#--##..##.##....##
#####..##....##----.#####..##...##
######.##....###..#######..###..##
######..##...###..##...###########
######..##....#####...---####.####
######.####...#####..----###..####
############..#####.-----.########
############..#######----.########
######....#####...#####--####..###
######.....####....####..###----.#
######.....####......######.----.#
######......##........#####.----.#
######......##........#####..---.#
######.....##..........#####.--..#
######.....##.........#######--..#
##################################
##################################