####################################
####################################
####################################
####################################
######........##...###......########
###.................#...###..#######
##########..............###..#######
###.....##.##...........###..#######
###-----...###..####....#.#.########
##.-----..###########...#...########
##.----#####.##....###..############
##.----#####..#.....################
##.--..####...#.......#.....########
####..........##......##....###....#
########...............#.##..#.....#
###...###................##.###....#
###....######........#...###########
##.......#####...##......###########
##..#.-----.########.....###########
##.##.-----.......###...############
##..#.-----.........##.###.#########
###.#.------..#............#########
###...--##--......#.......##########
###...######.........#....##########
####..######....#.......############
####..#######...#.......###.########
####..####.##...#....#..###.########
####...#.#..#.....####...#..########
######...#......####.........#######
####################################
####################################
####################################