###########################################
###########################################
###########################################
##############.....########################
#.................#########################
#...........##=############################
#..###########=############################
#..###########.....#########.....##########
#..###########.....=#.....##.....##########
#..------#####.....=#.....=#.....##########
#..------..###.....##.....=#.....##########
#..------...##.....###....###...###########
##.------...####==####....####==###########
#####.####..###########==##################
##########..####...##########...###########
##########..###....=#....###....###########
##...#...#..##.....=#....###....###########
##...#...#..###....##.....=#....###########
#....#...#..###...###.....=#....###########
#..#.#.#.#..####==####....###==############
#..#...#.#..###########==##################
#..#...#....###....#########.....##########
#..#...#...###.....##.....##.....##########
#..###########.....=#.....=#.....##########
#..###########.....=#.....=#.....##########
#..###########.....##.....##.....=#########
#....#..#...####==####...#######=.#########
#....#..#...###########==##########.#######
#....#..#...........########.........######
#....#..#.............................#####
##...#..#.............................#####
###########...........................#####
##############..............####....#######
###############..#######...################
###########################################
###########################################
###########################################