#######################################.....
#######################################.###.
#######################################.###.
#######################################.###.
####....#####.......................###.....
####....#####.#######........-------########
####....####..#######........-------########
####.....###..#######........-------########
####..........#######........-------########
####..........#################-----########
####..........##################----########
####..........###################---########
####..........##..###############---########
####.......................######...########
#######################....######...########
#######################....######...########
#######################....######...########
#######################....######...########
###.###################....######...########
##------......#########....######...########
##------......#########....######...########
##------##....##....###....######...########
##------##....##.....############...########
##------##....##.....##....######...########
##------##....###....##....######...########
##......##....##.....##....######...########
##......##....#########....######...########
##########....#########....######...########
#####..###....#########....######...########
#####..###....#########....######...########
#####..###....#########....######...########
#####..###....#########....#######.#########
#####..###....#########....#######.#########
#####..###....#########....######...########
##......##....########.#...######.#..#######
##......##.............#...######....#######
##......##.............#...######...########
############################################
############################################
############################################
############################################
############################################
############################################
############################################