################################
##########...###........###..###
##########....##..............##
###.....###...##........#.....##
###............##########.....##
###.....###....#######..##....##
###.....##.....#------..##....##
###.....#...####-----...##....##
###.....########----....##....##
###.....####..##---.....##....##
###.....####--##--##############
###......##---##-.#######.....##
###.....##-#---##########.....##
###.....##------##............##
###.....##------.########.....##
###.....##...######..###########
###.....#.#######.....#..#######
###.....#...######....#......###
###.....#....#####....##......##
###.....##..##...##...##......##
###.....######...##...##......##
####===####..#...##...##......##
####===##....#...##...##.....###
####===##....#...##..###########
####===#....##....#######.--####
####...##..#####.#######-----###
###.....###########....#-----###
##......###.----.##....#-----###
##.......#.------.#....#.----###
##.......#.------.#....##...####
###.....###.----.##....#########
################################
################################
################################
################################