###############################
###############################
###=#===##====#################
#####===##====#################
###=#===##====#################
##########################==###
###=###=====##############==###
#######=====#====##############
##===##=====#====#########...##
#=#=#=##====#===##########..###
#=###=##====#############...###
####==##====###..########...###
#==#=##########..#.######...###
##=#############.#..#####....##
####==##########...#######...##
#=#=#=####..#####......###...##
#==##=###.....####...####....##
##=#=###.......#####....#....##
##===##.........####.........##
######...........####........##
##=#=#...........#####.......##
######...........##############
##=#=##.........#=#=#=#=#######
########.......################
##===####.....#####=====#######
##===#####...######=====#######
##===##############==#==#######
##===##########################
##==###########################
###############################
###############################
###############################
###############################
###############################