#######################
#######################
###########.###########
###########.###########
###########.###########
##########...##########
##########...##########
######.###...###.######
######..##...###.######
###.##.###...###.##.###
###.##.##.....##.##.###
###.##........##.##.###
###.................###
###.................###
###..............#..###
###..................##
#####...########....###
###.....###.###..##.###
###.##...##.##...#..###
###########.####....###
###########.###########
###########.###########
###########.###########
###########.###########
##########..###########
#######################